; Default CSSE2002 Pacman Map
; board Keys
; getWidth, getHeight
;   - X Wall
;   - 0 No Item, 1 dots
;   - B Big dots spawn ( occupied ), b big dot spawn ( not occupied )
;   - $ Ghost spawn zone
;   - P pacman spawn zone
[Board]
23,24
XXXXXXXXXXXXXXXXXXXXXXX
XBBBBBBBBBBXBBBBBBBBBBX
XBXXBXXXXBBXBBXXXXBXXBX
XBXXBXXBBBBBBBBBXXBXXBX
XBBBBBBBBBBXBBBBBBBBBBX
XBXXXXXXXBBXBBXXXXXXXBX
XBBBXBBBBBBBBBBBBBXBBBX
XBBBBBBBBBBPBBBBBBBBBBX
XBBXXXXXXXXXXXXXXXXXBBX
XBBBBBBBBBBBBBBBBBBBBBX
XBBBBXBXXXBBBXXXBXBBBBX
XXXXXXBXXXB$BXXXBXXXXXX
XBBBBXBXXXBBBXXXBXBBBBX
XBBBBBBBBBBBBBBBBBBBBBX
XBBXXXBBBBBBBBBBBXXXBBX
XBBXXXXXXXBXBXXXXXXXBBX
XBBBXBBBBBBXBBBBBBXBBBX
XBBBXBBXXXXXXXXXBBXBBBX
XBBBXBBBBBBXBBBBBBXBBBX
XBBBBBBBBBBXBBBBBBBBBBX
XBXXBXXBBBBXBBBBXXBXXBX
XBXXBXXXXBBXBBXXXXBXXBX
XBBBBBBBBBBXBBBBBBBBBBX
XXXXXXXXXXXXXXXXXXXXXXX

[Game]
title = AHHHHHHHHHHHHHHH
author = WBO
lives = 5
level = 2
score = 123
hunter = 1,1,LEFT,20,PHIL
blinky = 3,6,UP,FRIGHTENED:15
inky = 1,6,UP,SCATTER:7
pinky = 8,6,UP,FRIGHTENED:15
clyde = 6,4,UP,CHASE:4

; Must have one blank line between each block.
; Comments do not count as a line
[Scores]
A : 0
B : 5
C : 100